111111111111111111111
1P10000000000000000C1
1110000000000E0000C01
111111111111111111111