111111111111111111111
1E10000000000000000P1
1110000000000C0000C01
111111111111111111111