111111111111111111111
1C100000E0000000000P1
1110000000000E0000C01
111111111111111111111