111111
10P0C1
100001
100001
100001
100001
100001
100001
100001
100001
10E0N1
111111