1111111
111E111
1110111
1C000N1
1N0C001
10000C1
111P111
1111111
1111111