11111111111111111111111111111111111111111111111111111111111111111111
1C000N00001111111111111111111111111111111111111111111111111111111111
10111111101111111111111111111111111111111111111111111111111111111111
1010000000111CCCCCCCC11111111111111111111111111111111111111111111111
10101111101111000000011111111111111111111111111111111111111111111111
101011111011111CC000001111111111111111111111111111111111111111111111
101011111011100000C0001111111111111111111111111111111111111111111111
101C00010C000000000000CCCCCCCCCC1111111111111111111111111111111E1111
101001000111111111111CCCCCCCCCCCC11111111111111111111111111111101111
10100000000111111111111CCCCCCCCCC00000000N01111111111111111111101111
1000000000111111111111111111CCCCCCC111111000001111111111111111101111
100000001011CCCCC111111111111111111111111CCCC01111111111111111101111
10010000000000000001111CCCCCCC1111111111CCCCCCC011111111111111100111
100000100C111110000111100CC00111111111111111CCCCCCCC1110000001100011
111000001111110C000000001100011111110C0CCCC00000C0000C00111000000001
10C00000C011100000C00C001111C0000C00C1000000000000000001111000100111
1C1000001P110000C0000011100000000C000000000N0000000011111111000C1101
11111111111111111111111111111111111111111111111111111111111111111111